8
TTTTTTTT
TOOTOOFT
TTOOTOOT
TTOTOOTT
TOOOOOOT
TTOTOOOT
TOOOOTOT
TTTTTTTT
